XXXXXXXXXXXXXXXXXXXXXXXXXXXXXXXXXXXXXXXXXXXXXXXXXXXXXXXXXXXXXXXXXXXXXXXXXXXXXXXXXXXXXXXXXXXXXXXXXXXXX
P     X     X           X           X         X           X     X   X     X       X   X     X       X
X XXX X X X X XXXXXXX X XXX XXXXXXX X XXXXXXX X XXXXXXXXX XXX X X X XXX X X X XXXXX X X XXX X X XXX X
X   X X X X X X       X   X X     X X     X   X     X X   X   X X X     X X X       X X X X   X   X X
XXX X XXX XXX X XXXXXXXXX X X XXX X XXXXX X XXX XXX X X XXX XXX X XXXXXXX X XXXXXXXXX X X XXXXXXX XXX
X   X X   X   X X   X   X X X   X         X X     X X   X     X   X   X   X X   X   X     X     X   X
X XXX X XXX XXX XXX X X X X X XXXXXXXXXXXXX XXXXX X X XXXXXXX XXXXX X X XXX X X XXX XXXXXXX XXX XXX X
X   X X       X   X   X     X X         X X     X X X       X X     X X X X   X X       X   X     X X
XXX X XXXXXXX XXX X XXXXXXXXXXX XXXXXXX X XXXXX XXX XXXXXXX X X XXX X X X XXXXX X XXXXX X XXXXXXX X X
X   X X     X   X X X   X       X X   X X     X     X   X   X X X   X X X   X   X X     X X   X X X X
X XXX X XXX XXXXX X XXX X XXXXXXX X X X XXX X XXXXXXX X X XXX X X XXXXX X X X XXX X XXXXX X X X X X X
X X     X X X     X X   X     X   X X X   X X         X X   X X X     X   X X   X X     X   X X   X X
X XXXXXXX X X XXXXX X X XXXXX X XXX X XXX X XXXXXXXXXXXXXXX X X XXXXX XXXXX XXX X XXX XXXXXXX X XXX X
X   X         X       X   X   X   X X   X X X     X   X       X X   X     X X X   X   X   X   X X   X
XXX X XXXXX XXXXXXXXXXXXXXX XXXXX X XXX X X X XXX X X X XXXXXXX X XXXXX X X X XXXXX XXX X X XXX XXX X
X   X X   X X   X         X     X     X X X     X   X   X   X     X   X X X X     X X   X X X X X   X
X XXXXX X XXX X X XXXXXXX XXXXX XXXXXXX X XXXXXXXXX XXXXX X XXX XXX X X XXX XXX X X X XXX X X X X X X
X       X     X     X       X   X       X     X   X X     X   X X   X X   X     X X X X     X   X X X
X XXXXXXXXXXXXXXXXX X XXXXXXX XXX XXXXX XXXXX X X XXX XXXXXXX XXX XXX X X XXXXX XXX X XXXXXXX XXX X X
X         X X     X X X       X   X   X     X   X   X   X   X       X X X   X   X   X     X X X   X X
XXXXXXXXX X X XXX XXX X XXXXXXX X X X XXXXX XXXXXXX XXX XXX XXXXX XXX X XXX X XXX XXXXXXX X X X X X X
X     X X   X X X     X X       X X X     X X     X         X   X X   X   X   X   X   X   X   X X X X
X X X X XXX X X XXXXX X X XXXXXXX X XXXXXXX X XXXXXXXXXXXXXXX X XXX XXXXX XXXXX XXXXX X XXX XXXXX X X
X X X   X   X X       X X X     X X X         X         X     X   X   X       X X     X X   X     X X
X X XXXXX XXX XXXXXXXXX XXX XXX X X X XXXXXXXXX XXXXXXX X XXXXXXX X X XXXXX XXX XXX X X XXX XXX XXXXX
X X       X X         X X   X   X X   X   X   X X     X X X       X X   X   X       X X   X   X X   X
X XXXXXXXXX XXXXXXXXX X X XXX XXX XXXXX X X X X XXX XXX X XXXXXXX XXXXX X XXX XXXXXXXXXXX XXX X X X X
X   X         X       X X X   X         X   X X   X X   X       X       X X   X           X   X X X X
XXX X XXXXXXX X XXXXX X X X XXX XXXXXXXXXXXXX XXX X X XXXXXXXXX XXXXXXX XXX XXX XXXXXXXXXXX XXX X X X
X   X X       X     X X X X   X     X     X     X X   X         X   X   X     X X       X X   X   X X
X XXX X XXXXXXXXXXX XXX X XXX XXXXX X X XXX XXX X X XXX XXXXXXX X X XXXXX XXXXX X X XXX X XXX XXXXX X
X     X   X   X   X   X X X X   X X X X   X   X X X     X   X   X X         X   X X X       X     X X
XXX XXXXX X X X X XXX X X X XXX X X X XXX XXX XXX XXX XXX X X XXX XXXXXXXXXXX XXX X XXXXXXX XXXXX X X
X   X   X   X   X   X   X X     X   X   X   X   X   X X   X X X   X   X     X   X X     X   X X   X X
XXXXX X XXXXXXXXXXXXXXX X X XXXXX XXXXX X X XXX XXX XXX XXX XXX XXX X X XXX XXX XXXXXXX X XXX X XXX X
X     X X             X   X     X X   X X X   X   X       X     X X X   X   X   X   X   X   X X   X X
X XXXXX X XXXXXXXXXXX XXXXXXXXX X X X XXX XXX X XXXXXXXXX XXXXXXX X XXXXX XXX XXX X X XXXXX X XXX X X
X X   X   X     X     X     X   X   X     X   X X       X X     X X   X     X X   X   X   X   X X X X
X X X XXXXXXX X X XXXXX XXX X XXXXXXXXXXX XXXXX X XXXXX X X X X X XXX XXXXX X XXX XXXXXXX XXX X X X X
X X X   X     X X     X X X X X       X X X     X X X   X X X X     X   X X X   X       X X   X X X X
X X XXX X XXXXX XXXXX X X X X X X XXX X X X XXX X X X XXX XXX XXX XXXXX X X XXX XXXXXXX X X XXX X X X
X X X     X X   X   X X X X   X X X   X   X X   X X X   X     X X X     X X     X       X X X   X X X
X X XXXXXXX X XXX X X X X XXXXXXX X XXX XXX X XXX X XXX XXXXXXX X X XXXXX XXXXXXX XXXXXXX X XXX X X X
X X X     X X   X X   X           X X   X X X   X X   X X   X   X X   X   X     X X   X   X X   X   X
X X X XXX X XXX X XXXXXXXXXXXXXXXXX XXX X X XXXXX X X X X XXX X X XXX X X XXX X X X X XXX X X XXXXX X
X X   X   X     X     X         X X   X   X   X   X X X X     X   X   X X     X   X X     X   X     X
X X XXX XXX XXXXXXXXX X XXX XXX X XXX X XXXXX X XXX X X XXXXXXXXXXX XXX XXXXXXXXXXX XXXXXXXXX X XXXXX
X X   X X   X   X     X   X   X   X   X X   X X X   X               X   X       X           X X X   X
X XXX X XXX XXX X XXXXX XXXXX XXX X XXX X X X X XXXXXXXXXXXXXXXXXXXXX XXXXX XXXXX XXXXXXX X X X X X X
X X X X   X   X X X     X     X   X X   X X   X             X     X   X   X       X     X X X X X X X
X X X XXX XXX X X XXXXX X XXXXXXXXX XXXXX XXX XXXXXXXXXXXXX X XXX XXX X X XXXXXXXXX XXX X X X X XXX X
X X X   X   X   X     X X X     X   X     X X   X         X X   X   X   X         X   X X X X X     X
X X XXX XXX X XXXXXXX X X X XXX X XXX XXXXX XXX XXXXX XXXXX XXX XXX X XXXXXXX XXX XXX X X XXX XXXXX X
X X     X X X X     X X X     X X X   X   X   X X   X   X     X X X X X     X X X   X X X   X   X   X
X X XXXXX X XXX X X X X XXXXXXX X XXX X XXX X X X X XXX X XXX X X X XXX XXX X X X X X X X X XXX X XXX
X X     X X   X X X X X X       X   X X   X X   X X     X X   X X X     X X X   X X X X X X     X   X
X XXXXX X XXX X X XXX XXX XXXXX XXX X XXX X XXXXX XXXXX X X XXX X XXXXXXX X XXX X XXX X XXX XXXXXXX X
X X   X   X   X X     X   X       X X   X X     X   X X X X X   X     X   X   X X   X X   X       X X
X XXX XXX X XXX XXXXXXX XXX XXXXXXX XXX X XXXXX XXX X X X X X XXXXX X X X XXX XXXXX X XXX XXXXXXX X X
X   X   X X   X   X       X     X   X   X X   X X   X   X X X     X X   X   X X   X X X X       X X X
X X X XXX XXX XXX X XXXXX XXXXX X XXX XXX X X X X XXX XXX XXXXXXX XXX XXXXX X X X X X X XXXXXXX XXX X
X X X       X   X X   X   X     X X   X   X X X X X X   X       X   X     X X   X X     X     X     X
XXX X XXXXX XXX X XXXXX X XXXXX X X XXX XXX X X X X XXX XXXXXXX XXX XXXXXXX XXXXX X XXXXX XXX XXX XXX
X   X X   X X   X X     X X   X X X X   X   X   X X     X   X     X           X   X   X     X   X   X
X XXXXX X XXX X X X XXXXXXX X XXX X X XXX XXXXXXX X XXXXX XXX XXXXXXXXXXXXX XXX XXX XXX XXXXX X XXXXX
X X     X     X X X     X   X       X     X       X   X   X   X         X   X   X   X   X   X X     X
X X X XXX XXXXXXX XXXXX X XXXXXXXXXXX XXXXXXX XXXXXXX XXX X XXX XXX XXXXX XXX XXXXXXX XXX X XXX XXX X
X X X   X X       X   X X   X   X   X       X X     X     X       X       X X         X   X   X X   X
X XXXXX XXX XXXXXXX X X XXX XXX X X XXXXXXX X X X XXX XXXXXXXXXXX XXXXXXXXX XXXXXXXXXXX XXXXX XXX X X
X     X     X       X X         X X       X   X X     X         X           X       X   X   X   X X X
XXXXX X XXXXXXX XXXXX XXXXX XXXXX XXXXXXX XXXXX XXXXXXX XXX XXX XXXXXXXXXXX X XXXXX X XXX XXXXX X X X
X     X       X   X X X   X X   X X   X   X   X X     X X X X X       X   X X     X   X   X     X X X
X XXXXXXXXXXX X X X X X X X X X X X XXX XXX XXX XXX X X X X X XXXXXXX X X X XXXXX XXXXX XXX XXXXX XXX
X X     X   X X X X X X X X X X   X X   X X   X   X X X X   X X       X X X     X   X X     X   X   X
X X XXX X X X XXX X X X X X X XXXXX X XXX X X XXX X X X X XXX X XXXXXXX X XXX XXXXX X X XXXXX X XXX X
X   X   X X X     X X   X X X   X   X X     X       X X X   X X X       X   X X     X   X X   X   X X
XXXXX XXX X XXXXXXX XXXXX XXXXX X X X XXXXXXXXXXXXXXX X X XXX X X XXXXXXXXX XXX XXXXX XXX X X XXX X X
X     X   X           X   X   X X X X   X   X   X     X X X   X   X     X   X   X X   X   X X   X   X
X XXXXX XXXXXXXXXXX X X XXX X X X XXXXX X X X X XXXXXXX XXX XXXXXXX XXXXX XXX XXX X XXXXX X XXX XXX X
X     X     X   X   X X     X   X     X   X X X         X   X   X     X   X     X X     X     X   X X
XXXXX XXX XXX X X XXXXXXXXXXX XXXXX X XXXXX X XXXXXXX XXX XXX X XXXXX X XXX XXX X XXXXX XXXXXXXXX X X
X   X X   X   X   X       X   X   X X     X   X     X X   X   X   X   X X X   X X     X     X   X X X
X X X XXX X XXX XXX X XXXXX XXX X X XXXXXXXXXXX XXXXX X XXX X XXX X XXX X XXX X XXXXX XXXXX X X X XXX
X X X   X X   X X   X       X   X X             X     X X   X X X X X   X X   X X         X   X X   X
X X XXX X XXX XXX XXXXXXXXXXX XXX X XXXXXXXXX X X XXXXX X XXX X X X X XXX X XXX X XXX XXXXXXXXX XXX X
X X X   X   X     X     X   X X X X   X X   X X       X X X   X   X X X     X X X   X X       X     X
X X X XXXXX XXXXX XXX X X XXX X X XXX X X X X XXXXXXXXX X X XXXXX X X X XXXXX X XXX XXX XXXXX XXXXX X
X X   X X   X   X     X   X     X X X X X X X X X       X X     X X X X       X   X       X X   X   X
X XXXXX X XXX X XXX XXXXXXX XXXXX X X X X X X X X XXXXXXXXXXXXX X X X XXXXXXX XXX XXXXXXX X XXX X XXX
X   X     X   X   X X       X     X     X X X   X     X   X     X X X   X     X X X     X X   X X   X
X X XXXXXXX XXXXX XXX XXXXXXX XXXXX XXXXX X XXX XXXXX X X X XXXXX X XXX XXX XXX X X XXX X XXX X XXX X
X X       X X X   X   X   X X X     X X   X   X X   X   X X   X       X   X     X     X X X   X X   X
X XXXXXXX X X X XXX XXX X X X XXX XXX X XXXXX XXX X XXXXX X X XXXXX XXXXX XXXXX XXXXXXX X X XXX X XXX
X X   X X X X X     X   X X X   X X   X   X X X   X   X   X X   X   X   X     X     X   X   X   X X X
X X X X X X X XXXXXXXXX X X XXX X XXX XXX X X X XXXXX X XXXXXXX XXXXX X XXXXX XXXXXXX XXXXX X XXX X X
X X X X X   X       X   X X   X X     X   X X X X X   X       X X     X     X         X   X X   X   X
X X X X XXXXX XXXXX X XXX XXX X XXXXXXX XXX X X X X XXXXXXXXX X X XXXXXXXXX XXXXXXXXXXX X X XXX XXX X
X   X   X     X     X X X   X X X     X     X X X X X   X   X X X X     X               X X X   X   X
XXXXXXX XXX XXX XXXXX X XXX X X X XXX XXXXX X X X X X X X X X X X XXX X X XXXXXXXXXXXXXXXXX X XXX XXX
X           X         X       X     X       X     X   X   X   X       X X                   X       K
XXXXXXXXXXXXXXXXXXXXXXXXXXXXXXXXXXXXXXXXXXXXXXXXXXXXXXXXXXXXXXXXXXXXXXXXXXXXXXXXXXXXXXXXXXXXXXXXXXXXX
