XXXXXXXXXXXXXXXXXXXXX
P X           X     X
X X XXXXX XXX X XXX X
X X   X X   X   X   X
X XXX X XXX XXXXX XXX
X   X X   X X       X
X X X X X X XXXXXXX X
X X X   X X X   X X X
X X XXXXX X X X X X X
X X       X X X   X X
X XXXXXXXXX X XXXXX X
X X     X   X     X X
X X XXX X X XXXXX X X
X X   X X X     X X X
X XXX X X XXX XXX X X
X X   X X   X X   X X
X X XXX XXX XXX XXX X
X X X X   X X   X X X
X X X XXX X X XXX X X
X   X     X   X     K
XXXXXXXXXXXXXXXXXXXXX
